# Level 2 — Below Deck (Medium)
# Rope climbing, thin platforms, barrels, more crabs
...............................................................
...............................................................
........................K.......M..............................
......................----......#.....K........................
...K........................C..#...----......=========.........
..----..............R......=====#..........C...................
.............C......R..........#....====.......................
..........=====.....R......K...#.........R.....C...............
.................#..R....----...#.........R...=====............
.P...KKKK........#..R..........#...B.....R.................F.=.
===..........====##====..C...==###=====..R..........====..===..
#####=###==#######=====####=################=====#=###=######..
~~~~~~~~~~~~~~~~~~~~~~~~~~~~~~~~~~~~~~~~~~~~~~~~~~~~~~~~~~~~~~.
~~~~~~~~~~~~~~~~~~~~~~~~~~~~~~~~~~~~~~~~~~~~~~~~~~~~~~~~~~~~~~.
